d___0000__00000
00___000__0__00
0__0__00____000
00_______0___00
0000_00___00000
00___000000____
______00000__00
000____00___000
0000______00000
0000000______00
0000__0__000000
________0000_00
_____0__0____00
000000____00000
0000000_0____ag
