d________00_000
0000_000_00_000
00000000_____00
0_____0__000000
__000_00_000000
0_000_00_____00
0_0___000000_00
0_0_000___00_00
0_0___0_0000__0
0_0_000_0000_00
0_0__________00
0_0_0000000_000
__00000_000____
0_________00000
000__000_____ag
